-43,-52,-71,0,0,0,-90,-97,-97,0,0,0,0
-52,-47,-70,0,-94,0,0,0,-93,0,0,0,0
-37,-48,-64,-92,0,-90,0,0,0,0,0,0,0
-43,-61,-74,0,-87,0,0,0,-94,0,0,0,0
-57,-51,-67,0,-87,0,-89,-86,-95,-89,-90,0,0
-43,-59,-68,-90,0,0,0,0,0,0,0,0,0
-48,-44,-70,-91,-86,0,0,0,-90,0,0,0,0
-45,-54,-70,0,-88,0,0,-86,-88,0,0,0,0
-46,-60,-69,0,-95,0,-86,-84,0,0,0,0,0
-52,-57,-73,0,-90,0,0,-86,-91,0,0,0,0
-44,-51,-70,0,-93,0,-91,-84,-86,-91,-91,0,0
-43,-52,-71,0,0,0,-90,-97,-97,0,0,0,0
-52,-47,-70,0,-94,0,0,0,-93,0,0,0,0
-37,-48,-64,-92,0,-90,0,0,0,0,0,0,0
-43,-61,-74,0,-87,0,0,0,-94,0,0,0,0
-57,-51,-67,0,-87,0,-89,-86,-95,-89,-90,0,0
-43,-59,-68,-90,0,0,0,0,0,0,0,0,0
-48,-44,-70,-91,-86,0,0,0,-90,0,0,0,0
-45,-54,-70,0,-88,0,0,-86,-88,0,0,0,0
-46,-60,-69,0,-95,0,-86,-84,0,0,0,0,0
-52,-57,-73,0,-90,0,0,-86,-91,0,0,0,0
-44,-51,-70,0,-93,0,-91,-84,-86,-91,-91,0,0
